################S############
#s..........................#
#.....#......#..............#
#.........Z..#..............#
#............#...........Z..#
#............#..............#
#V.......#####..............#
#...........Z#..............#
#............#...........H..#
#f..........................#
########################E####
