################S############
#s...........s..............#
#.....#......#..............#
#.........Z..#..............#
#............#...........Z..#
#............#..............#
#V.......#####..............#
#...........Z#..............#
#............#...........H..#
#f...........f..............#
########################E####
