################S############
#s..........................#
#.....#......#..............#
#............#..............#
#............#..............#
#............#..............#
#........#####..............#
#............#..............#
#............#...........H..#
#f..........................#
########################E####
